map_width: 840
map_height: 560
tpl: 21
01 01 00 00 01 01 00 00 01 01 00 00 01 01 00 00 01 01 00 00 00 
01 01 00 00 01 01 00 00 01 01 00 00 01 01 00 00 01 01 00 00 01
00 01 00 01 00 01 00 01 00 01 00 01 00 01 00 01 00 01 00 01 00 
01 00 01 00 01 00 01 00 01 00 01 00 01 00 01 00 01 00 01 00 01 
00 01 00 01 00 01 00 01 00 01 00 01 00 01 00 01 00 01 00 01 00 
01 00 01 00 01 00 01 00 08 00 01 00 01 00 01 00 01 00 01 00 01
00 01 00 01 00 01 00 01 02 02 08 01 00 01 00 01 00 01 00 01 00 
01 00 01 00 01 00 01 08 02 02 01 00 01 00 01 00 01 00 01 00 01 
00 01 00 01 00 01 00 01 00 08 00 01 00 01 00 01 00 01 00 01 00 
01 00 01 00 01 00 01 00 01 00 01 00 01 00 01 00 01 00 01 00 01 
00 01 00 01 00 01 00 01 00 01 00 01 00 01 00 01 00 01 00 01 00 
01 00 01 00 01 00 01 00 01 00 01 00 01 00 01 00 01 00 01 00 01
00 01 00 01 00 01 00 01 00 01 00 01 00 01 00 01 00 01 00 01 00 
01 00 01 00 01 00 01 00 01 00 01 00 01 00 01 00 01 00 01 00 01