map_width: 920
map_height: 560
tpl: 23
00 01 02 00 01 02 00 01 02 00 01 02 00 01 02 00 01 02 00 01 02 00 01
01 02 00 01 02 00 01 02 00 01 02 00 01 02 00 01 02 00 01 02 00 01 02
02 00 01 02 00 01 02 00 01 02 00 01 02 00 01 02 00 01 02 00 01 02 00
00 01 02 00 01 02 00 01 02 00 01 02 00 01 02 00 01 02 00 01 02 00 01
01 02 00 01 02 00 01 02 00 01 02 00 01 02 00 01 02 00 01 02 00 01 02
02 00 01 02 00 01 02 00 01 02 00 01 02 00 01 02 00 01 02 00 01 02 00
00 01 02 00 01 02 00 01 02 00 01 02 00 01 02 00 01 02 00 01 02 00 01
01 02 00 01 02 00 01 02 00 01 02 00 01 02 00 01 02 00 01 02 00 01 02
02 00 01 02 00 01 02 00 01 02 00 01 02 00 01 02 00 01 02 00 01 02 00
00 01 02 00 01 02 00 01 02 00 01 02 00 01 02 00 01 02 00 01 02 00 01
01 02 00 01 02 00 01 02 00 01 02 00 01 02 00 01 02 00 01 02 00 01 02
02 00 01 02 00 01 02 00 01 02 00 01 02 00 01 02 00 01 02 00 01 02 00
00 01 02 00 01 02 00 01 02 00 01 02 00 01 02 00 01 02 00 01 02 00 01
01 02 00 01 02 00 01 02 00 01 02 00 01 02 00 01 02 00 01 02 00 01 02
02 00 01 02 00 01 02 00 01 02 00 01 02 00 01 02 00 01 02 00 01 02 00
00 01 02 00 01 02 00 01 02 00 01 02 00 01 02 00 01 02 00 01 02 00 01