width: 640
height: 480
tpl: 16
00 01 02 00 01 02 00 01 02 00 01 02 00 01 02 00
01 02 00 01 02 00 01 02 00 01 02 00 01 02 00 01
02 00 01 02 00 01 02 00 01 02 00 01 02 00 01 02 
00 01 02 00 01 02 00 01 02 00 01 02 00 01 02 00 
01 02 00 01 02 00 01 02 00 01 02 00 01 02 00 01 
02 00 01 02 00 01 02 00 01 02 00 01 02 00 01 02
00 01 02 00 01 02 00 01 02 00 01 02 00 01 02 00 
01 02 00 01 02 00 01 02 00 01 02 00 01 02 00 01 
02 00 01 02 00 01 02 00 01 02 00 01 02 00 01 02 
00 01 02 00 01 02 00 01 02 00 01 02 00 01 02 00 
01 02 00 01 02 00 01 02 00 01 02 00 01 02 00 01 
02 00 01 02 00 01 02 00 01 02 00 01 02 00 01 02 