08 08 08 08 08 08 08 08 08 08 08 08 08 08 08 08 08 08 08 08 08 
08 00 00 00 00 00 00 00 00 00 00 00 00 00 00 07 00 00 00 01 08 
08 00 00 00 00 00 00 00 00 00 00 00 00 00 08 07 00 00 00 00 08 
08 00 00 00 00 00 07 07 00 00 00 00 00 00 08 07 00 00 00 00 08 
08 00 00 00 00 00 07 00 00 00 00 00 07 00 00 07 09 00 00 00 08 
08 00 00 00 00 00 00 00 08 08 08 00 07 07 00 07 07 07 07 07 08 
08 00 00 00 00 00 00 00 08 07 08 00 00 00 00 00 10 08 08 10 08 
08 00 00 00 00 00 00 00 08 08 07 08 08 00 00 00 00 00 00 00 08 
08 00 00 00 00 00 00 00 00 00 08 07 08 00 00 00 00 00 00 00 08 
08 00 00 00 00 00 00 07 07 00 08 08 08 00 00 00 00 00 00 00 08 
08 00 00 00 00 00 00 00 07 00 00 00 00 00 07 00 00 00 00 00 08 
08 00 00 00 00 00 00 00 00 00 00 00 00 07 07 00 00 00 00 00 08 
08 00 00 00 00 00 00 00 00 00 00 00 00 00 00 00 00 00 00 00 08 
08 08 08 08 08 08 08 08 08 08 08 08 08 08 08 08 08 08 08 08 08