08 08 08 08 08 08 08 08 08 08 08 08 08 08 08 08 08 08 08 08 08 
08 01 00 08 08 00 00 00 08 00 00 00 00 08 00 00 00 00 00 00 08 
08 00 00 08 08 00 00 00 00 00 00 00 00 00 11 00 00 00 00 00 08 
08 00 00 00 00 00 00 00 00 00 00 00 00 00 00 00 00 00 00 00 08 
08 00 00 00 00 00 00 00 00 00 00 00 00 00 00 00 00 00 00 00 08 
08 00 00 08 08 00 00 00 00 00 00 00 00 00 00 00 00 00 00 00 08 
08 00 09 07 07 10 00 00 00 00 00 00 00 00 11 00 00 00 00 00 08 
08 00 09 07 07 10 00 00 00 00 00 00 00 00 11 00 00 00 00 00 08 
08 00 00 08 08 00 00 00 00 00 00 00 00 00 00 00 00 00 00 00 08 
08 00 00 00 00 00 00 00 00 00 00 00 00 00 00 00 00 00 00 00 08 
08 00 00 00 00 00 00 00 00 00 00 00 00 00 00 00 00 00 00 00 08 
08 00 00 08 08 00 00 00 00 00 00 00 00 00 11 00 00 00 00 00 08 
08 01 00 08 08 00 00 00 08 00 00 00 00 08 00 00 00 00 00 00 08 
08 08 08 08 08 08 08 08 08 08 08 08 08 08 08 08 08 08 08 08 08