08 08 08 08 08 08 08 08 08 08 08 08 08 08 08 08 08 08 08 08 08 
08 00 00 00 00 00 00 00 00 00 00 00 00 00 00 00 00 00 00 00 08 
08 00 00 08 08 08 00 00 00 00 00 00 00 00 11 08 00 00 00 00 08 
08 00 00 00 08 00 00 00 00 00 00 00 00 00 00 08 00 00 00 00 08 
08 00 00 00 08 00 08 08 08 00 00 08 08 08 00 08 08 08 00 00 08 
08 00 00 00 08 00 00 08 00 00 00 00 00 08 00 08 07 08 00 00 08 
08 00 00 08 08 08 00 08 00 08 08 08 00 08 00 08 08 08 00 00 08 
08 00 00 00 00 00 00 08 00 00 00 08 00 08 00 00 00 00 00 00 08 
08 00 00 00 00 00 00 08 00 08 08 08 00 08 00 00 00 00 00 00 08 
08 00 00 00 00 00 00 00 00 08 01 00 06 06 06 00 00 00 00 00 08 
08 00 00 00 00 00 00 00 00 08 08 08 00 00 00 00 00 00 00 00 08 
08 00 00 00 00 00 00 08 00 00 00 00 00 08 00 00 00 00 00 00 08 
08 00 00 00 00 00 00 08 08 00 00 00 08 08 00 00 00 00 00 00 08 
08 08 08 08 08 08 08 08 08 08 08 08 08 08 08 08 08 08 08 08 08