08 08 08 08 08 08 08 08 08 08 08 08 08 08 08 08 08 08 08 08 08 
08 00 00 00 00 00 00 00 00 00 00 00 00 00 00 00 00 00 00 01 08 
08 07 07 07 07 07 07 07 07 07 07 07 07 07 07 07 07 07 07 07 08 
08 07 07 07 07 07 07 07 07 07 07 07 07 07 07 07 07 07 07 07 08 
08 00 00 00 00 00 00 00 00 00 00 00 00 00 00 00 00 00 00 10 08 
08 00 00 00 00 00 00 00 00 00 00 00 00 00 00 00 00 00 00 00 08 
08 00 08 08 00 00 00 00 00 00 00 00 00 00 00 08 08 00 00 00 08 
08 00 08 00 00 00 00 00 00 00 00 00 00 00 00 00 08 00 00 00 08 
08 00 08 00 08 00 00 00 00 00 00 00 00 00 00 00 08 00 00 00 08 
08 00 00 00 08 00 00 00 00 00 00 00 00 00 00 08 08 00 00 00 08 
08 00 08 00 00 00 00 00 00 00 00 00 00 00 00 00 00 00 08 00 08 
08 08 08 08 00 00 00 00 00 00 00 00 00 00 00 00 00 08 08 00 08 
08 06 06 06 06 11 06 06 06 06 06 06 06 06 06 06 06 06 06 06 08 
08 08 08 08 08 08 08 08 08 08 08 08 08 08 08 08 08 08 08 08 08