map_width: 840
map_height: 560
tpl: 21
00 01 02 00 01 02 00 01 02 00 01 02 00 01 02 00 01 02 00 01 02 
01 02 00 01 02 00 01 02 00 01 02 00 01 02 00 01 02 00 01 02 00 
02 00 01 02 00 01 02 00 01 07 00 01 02 00 01 02 08 01 02 00 01 
00 01 02 07 01 02 00 01 02 00 01 02 00 01 02 00 01 02 00 01 02 
01 02 00 01 02 00 01 02 00 01 02 00 01 02 00 01 02 00 01 02 00 
02 00 01 02 00 01 02 00 01 02 00 01 02 00 01 02 00 01 02 00 01 
00 01 02 00 01 02 00 01 02 00 01 02 00 01 02 00 01 02 00 01 02 
01 02 00 01 02 00 01 02 00 01 02 08 01 02 00 01 02 00 01 08 08 
02 00 01 02 00 01 02 00 01 02 00 01 02 00 01 02 00 01 02 00 01 
00 01 02 00 01 02 07 01 02 00 01 02 00 01 02 00 01 02 00 01 02 
01 02 00 01 02 00 01 02 00 01 02 00 01 02 00 01 08 00 01 02 00 
02 00 01 02 00 01 02 00 01 02 00 07 02 00 01 02 00 01 02 00 01 
00 01 02 00 01 02 00 01 02 00 01 02 00 01 02 00 01 02 00 01 02 
01 02 00 01 02 00 01 02 00 01 02 00 01 02 00 01 02 00 01 02 00 